# Studies
H1 = "H1N1"
H3 = "H3N2"
RH = "Rhinovirus"

# Subchallenges
S1 = "subchallenge 1"
S2 = "subchallenge 2"
S3 = "subchallenge 3"

# Timepoints
T0 = "timepoint 0h"
T2 = "timepoint 24h"

# Team Names
NA = "team Nautilus"
AY = "team aydin" -- sig/pos correlation, both subchallenges, both timepoints
SS = "team SSN_Dream_Team" -- sig/pos correlation, both subchallenges, both timepoints
TX = "team Txsolo"
CW = "team cwruPatho" -- sig/pos correlation, subchallenge 3, both timepoints
AG = "team Aganita"
BW = "team bw"
CG = "team CGATeam"
CT = "team ChengzheTian"
CF = "team ChristoferF" -- sig/pos correlation, subchallenge 2, both timepoints
ES = "team ES.SJ_PREDICTOMI"
ER = "team Espoir" -- sig/pos correlation, subchallenge 2, both timepoints
GN = "team Gustavssonlab_Nordlinglab"
PH = "team PrecisionHunter"
RC = "team Rchow"
SK = "team SBiE_KAIST"
SC = "team SchrodingersCat" ++ (all predictors) sig/pos correlation, both subchallenges, both timepoints
SH = "team Shosty"
SU = "team SunilKumar"
TD = "team TempleDABI"
VP = "team ViResPred" ++ (all predictors) sig/pos correlation, subchallenge 3, both timepoints
JD = "team jdn" -- sig/pos correlation, both subchallenges, both timepoints
JH = "team jhou" -- sig/pos correlation, both subchallenges, both timepoints
FA = "team FLU_ATTACK" -- sig/pos correlation, subchallenge 2, both timepoints
JK = "team JayHawks"
HV = "team hackvirus"
BK = "team burkhajo" -- sig/pos correlation, subchallenge 3, both timepoints
